    NO    texure/no.xpm
SO texure/so.xpm
WE       texure/we.xpm






F 51,46,96
C 239,238,143

EA texure/ea.xpm


1111111111
1000000001
1000100101
 1000100001
100E000001
1111111111
1001110001
1111  1111